1111111111111
10P0000000001
10000CMC01C01
100000CC01E01
1000000000001
1000000000001
1000000000001
10000MMC00001
1000000000M11
1111111111111